SSSSSSSSSSSSS
SSSSSSSSSSSSS
SSSSSSSSSSSSS
SSSSSSSSSSSSS
SSSPSSSSSSSSS
4555555555555
3333333333333
3333333333333
3333333333333
3333333333333
